*********************
*AAA*AAA*AAAAAAAAAAG*
*A*A*A*****A*****A*A*
*A*A*A*AAA*AAAAA*A*A*
*A*A*A*AAA*AAAAA*A*A*
*A*AAA*AAA*AAAAA*A*A*
*A*****AAA*A*AAA*A*A*
*AAAAA*AAA*A*AAA*A*A*
*****A*A***********A*
*PAAAAAAAAAAAAAAAAAA*
*********************
