*********************
*A*AAA*AAAAAAAAAAAAP*
*A*A*A*A***A***A*****
*A*A*AAA*AAAAAAA*AAA*
*A*A*****AAAAA*A*A*A*
*AAA*AAA*AAAAA*A*A*A*
*A***A*A*******A*A*A*
*A*AAA*A*A*A*AAAAA*A*
*A*A***A*A*A*******A*
*AAA*AAGAA*AAAAAAAAA*
*********************
