*********
**G   F**
**** ****
**** ****
**** ****
**** ****
**** ****
**P   S**
*********
