*********
*PAAAAAA*
*AA***AA*
*A*AAA*A*
*A***A*A*
*AAA*AAA*
*A*A*****
*A*AAAAG*
*********