*************
*PAAAAAA*AAA*
*A*******A*A*
*A*AAAAAAAAA*
*A*A*A*****A*
*AAAAAAAAA*A*
*A***A***AAA*
*A*A*A*A*A*A*
*AAA*AAA*A*A*
*A*A*A*AAA*A*
*A*AAAAA***A*
*AAA*G*AAAAA*
*************