***********
*PAA*AAAAA*
*A*A*A*A***
*A*A*A*AAA*
*A***AA**A*
*A*AAA*AAA*
*A*A***A*A*
*A*AAAAA*A*
*AA*AA*AAA*
*AAAAA*GAA*
***********