*************
*P*AAAAAAAAA*
*A*AAA***A*A*
*AAA*AAAAA*A*
*A***A*A***A*
*AAG*AAAAA*A*
***A*A*A*A*A*
*AAAAAAAAA*A*
*A*******A*A*
*AAAAAAAAAAA*
*AA**A**A**A*
*AAAAA*AAAAA*
*************