*********
*PAAAAAA*
***A*A*A*
*AAAAA*A*
*A*****A*
*AAG*AAA*
*****A***
*AAAAAAA*
*********