*********
*PAGAAAA*
*A*****A*
*AAAAAAA*
*AA**A***
*AAAAA*A*
*A*A*A*A*
*AAAAAAA*
*********