*************
*P*AAAAAAAAA*
*A*A****A**A*
*AAAAAAAAA*A*
*AA*****A**A*
*A*AAAAAAAAA*
*A*A***A***A*
*A*A*AAAAAAA*
*A*A***A***A*
*A*AAA*AAAAA*
*A*A*AA****A*
*AAA*G*AAAAA*
*************