*********
*PAAAA*G*
*A*AAA*A*
*A*AAA*A*
***A***A*
*AAA*AAA*
*AAA*A***
*AAAAAAA*
*********