*************
*PAA*AAG*AAA*
***A*A***AAA*
*AAA*A*AAA*A*
*A***A*A***A*
*AAAAA*AAA*A*
*A*A*****A*A*
*AAAAAAA*AAA*
*A*****A*A*A*
*AAAAAAA*A*A*
*A*A******AA*
*AAAAAAAAAAA*
*************