*********
*PAAAAAA*
*AA****A*
*AAAAA*A*
****A*AA*
*AAAAA*A*
*A*A*AAA*
*GAAAAAA*
*********