*************
*PAA*AAAAAAA*
*A*A*A*A***A*
*A*AAA*AAAAA*
*A*****A**AA*
*A*GAAAAAA*A*
*AA*AA***A*A*
*A*A*AAA*AAA*
*A*AAA*A*****
*A*AAA*AAAAA*
*A**A******A*
*AAAAAAAAAAA*
*************