*************
*PAAAA*AAAAA*
*A***AA**AAA*
*AAA*AAAAA*A*
**AAA******A*
*AAA*AAAAAAA*
*A*A***A*A***
*A*A*AAA*A*A*
*A*A*A***A*A*
*AAG*AAAAA*A*
*A***A*A***A*
*AAAAAAAAAAA*
*************