*************
*PAAAAAAAAAA*
*A***A*****A*
*AAA*A*AAAAA*
*A*AA**A*A***
*A*AAAAAAAAA*
*A*********A*
*A*AAAAAAAAA*
***A*******A*
*AAA*AAA*AAA*
*AA***AA*A***
*AAAAG*AAAAA*
*************