*********
*GPA*AAA*
***A**AA*
*A*AAAAA*
*A*****A*
*AAAAA*A*
*A*A***A*
*A*AAAAA*
*********