*********
*P*AAAAA*
*A*A***A*
*AAAAGAA*
*A*AA*A**
*A*AAA*A*
*AAA*A*A*
*AAA*AAA*
*********