*********
*PAA*AAA*
*A*AAA*A*
*A*AAA*A*
*AA****A*
*AAG*AAA*
****AA***
*AAAAAAA*
*********