*************
*PAAAAAAAAAA*
*A*******A*A*
*AAAAA*AAAAA*
*A*A*A*AA**A*
*AAAAA*AAAAA*
*******A***A*
*AAA*AAA*GAA*
*AAA*A*AA**A*
*A*AAA*AAA*A*
*A*********A*
*AAAAAAAAAAA*
*************