*************
*PAA*AAA*AAG*
**AAAA*A*A***
*AAA*A*AAA*A*
*A***A*****A*
*AAA*AAAAA*A*
*A*A*****A*A*
*A*AAAAA*AAA*
*A***A***A*A*
*AAA*AAA*AAA*
*A*A**AA***A*
*AAAAAAAAAAA*
*************