*********
*PAAAAAA*
*A*A*AAA*
*AAA*AAA*
*AA****A*
*AAAAG*A*
*******A*
*AAAAAAA*
*********