*************
*PAAAA*AAAAA*
*AAA*A*A***A*
*AAA*AAAAA*A*
***A***A**AA*
*G*AAA*AAAAA*
*AA**A*A*****
*A*AAA*AAAAA*
*A*A*******A*
*A*AAAAAAA*A*
*A*****A*AAA*
*AAAAAAAAAAA*
*************