*********
*PAA*AAA*
*AAA*A*A*
*AAAAA*A*
*A*A*A*A*
*A*A*A*G*
*A***A***
*AAAAAAA*
*********