*********
*PAA*AAA*
*A*A*AAA*
*A*AAA*A*
*A*******
*AAAAAAA*
*A*AA**A*
*AAAAA*G*
*********