*********
*P*AAAAA*
*A*A***A*
*AAA*AAA*
*A***AA**
*A*GAA*A*
*A*****A*
*AAAAAAA*
*********