*********
*P*AAAAA*
*A*AA**A*
*A*A*A*A*
*A*A*A*A*
*AAAAA*G*
*A***A***
*AAAAAAA*
*********