*********
*PAA*AAA*
*A*A*A*A*
*AAA*G*A*
*A*****A*
*A*AAAAA*
*A*A*****
*AAAAAAA*
*********