*********
*PAAAAAA*
*A*A*AA**
*AAAAAAA*
*AA*A**A*
*A*GAA*A*
*A*A*AAA*
*AAA*AAA*
*********