*************
*PAAAAAAAA*G*
*A*AAA*A***A*
*A*AAA*AAAAA*
*A**AA*A*****
*A*AAA*A*AAA*
*A*A***A*A*A*
*A*A*AAA*A*A*
*A***A*A*A*A*
*AAAAA*AAA*A*
*A*****A***A*
*AAAAAAA*AAA*
*************