*************
*PAAAAAAAAAA*
*A*A*A*****A*
*A*AAAAAAA*A*
*A*AAAA**A*A*
*A*A*AAAAAAA*
*A*A***A*A***
*AAA*GAA*AAA*
**A********A*
*AAAAAAAAAAA*
*A*****A***A*
*AAAAA*AAAAA*
*************