*********
*PAAAA*A*
***A*A*A*
*AAA*A*A*
*A***A*A*
*AAA*AAA*
*AAA*A*A*
*G*AAAAA*
*********