*********
*G*PAAAA*
*A*****A*
*AAAAAAA*
*A*****A*
*A*AAA*A*
*A*A*A*A*
*AAA*AAA*
*********