*************
*PAAAA*AAAAA*
*A*A***AA**A*
*AAAAAAAAG*A*
*A***A***A*A*
*A*AAA*A*A*A*
*A*A*A*AAA*A*
*AAA*A*A*AAA*
**A**A*A*****
*AAAAAAA*AAA*
*A*A***A***A*
*A*AAAAAAAAA*
*************