*************
*P*AAAAAAAAA*
*A*A*A*****A*
*AAA*AAA*AAA*
*A**A**A*A*A*
*A*GAAAA*A*A*
*AA*A*A*AA***
*A*AAAAAAAAA*
*A*A*A*****A*
*AAAAAAA*AAA*
*A*****A*A*A*
*AAAAAAAAA*A*
*************