*********
*P*GAAAA*
*A*A*A*A*
*A*AAA*A*
*A****AA*
*AAAAA*A*
*A*A***A*
*A*AAAAA*
*********