*********
*PAA*AAA*
*AAA***A*
*A*AAAAA*
*A*AA****
*A*AAAAA*
*A***A*A*
*AAAAA*G*
*********