*********
*PAA*AAA*
*AAAAAAA*
*A*AAA*G*
*AA***A**
*AAAAAAA*
*******A*
*AAAAAAA*
*********