*********
*PAA*AAA*
*A*A*A*A*
*AAA*A*A*
*A*A*A*A*
*A*A*G*A*
*A****AA*
*AAAAAAA*
*********