*********
*P*G*AAA*
*A*A*A*A*
*AAA*AAA*
*A*A*A***
*A*AAAAA*
*A*****A*
*AAAAAAA*
*********