*************
*GPA*AAAAAAA*
***A*A*A***A*
*A*A*AAA*AAA*
*A*A*A***A***
*A*A*A*A*AAA*
*A*AAA*A***A*
*A*AAA*AAAAA*
*A*****AA*A**
*A*AAAAA*AAA*
*A*A*A***A*A*
*AAAAAAAAA*A*
*************