*********
*PAAAA*A*
*A*AAA*A*
*A*A*A*A*
*A*A*A*A*
*A*AAA*A*
*A*A*A*A*
*A*G*AAA*
*********