*************
*P*AAAAAAAAA*
*A*A******AA*
*A*AAA*AAAAA*
*A***A*A*****
*A*AAAAAAAAA*
*A*A*A*A***A*
*A*AAAAA*AAA*
*A*A*****A*A*
*AAA*G*AAA*A*
*A*AAAAA***A*
*AAA*AAA*AAA*
*************