*********
*PAAAAAA*
*A*A***A*
*A*A*AAA*
*AAAA**A*
*A*AAA*A*
*A***A*A*
*AAA*G*A*
*********