*************
*PAAAAAAAAAA*
*A****AA*A*A*
*A*AAA*AAA*A*
*A*AAA*AAA*A*
*AAA*A*AAA*A*
*AA**A*A***A*
*AAA*AAA*GAA*
*A*AAA*******
*A*A*AAAAAAA*
*A*AA***AA*A*
*AAAAAAAAAAA*
*************