*********
*PAAAAAA*
*AA**A*A*
*AAA*AAA*
**A**A*A*
*AAAAG*A*
*AA**A*A*
*AAAAAAA*
*********