*********
*PAAAAAA*
*A*A*****
*A*AAAAA*
*A**A**A*
*AAAAA*A*
*******A*
*GAAAAAA*
*********