*************
*GPAAAAAAAAA*
*A***A*A*A*A*
*AAA*A*A*A*A*
*A*A*A***A***
*A*A*AAA*AAA*
*A*****A***A*
*AAAAAAA*AAA*
*A*******A*A*
*A*AAAAAAAAA*
*AAA*****A*A*
*AAA*AAAAAAA*
*************