*************
*PAAAAAA*AAA*
*A*****A***A*
*AAAAA*A*AAA*
*****AAA*A*A*
*AAA*G*AAAAA*
*AAA*A**A**A*
*A*AAA*AAA*A*
***AAA***A*A*
*AAA*AAAAA*A*
*A*AA******A*
*AAAAAAAAAAA*
*************