*************
*PAAAAAAAAAA*
**A**A***AA**
*AAAAA*AAAAA*
*A*****A***A*
*AAAAAAA*AAA*
*A*****A*AAA*
*AAAAAAAAA*A*
*AAA*******A*
*A*AAAAA*G*A*
*A****AA*A*A*
*AAAAA*AAA*A*
*************