*********
*G*PAA*A*
*A*A*AAA*
*AAA*A*A*
*A***A*A*
*AAA*AAA*
*A*****A*
*AAAAAAA*
*********