*************
*PAAAAAAAAAA*
*A*A****AA*A*
*A*AAAAA*AAG*
*A*****AA****
*AAAAA*A*AAA*
*AA*A**A*A*A*
*AAAAA*A*AAA*
*A*A*A*A*A***
*A*A*AAA*AAA*
*A*A***A*A*A*
*AAAAAAAAAAA*
*************