*************
*PAAAAAAAA*A*
*AA****A*A*A*
*A*AAAAA*AAA*
*A*AAA*A**AA*
*AAG*AAAAA*A*
*****A*****A*
*AAA*A*AAAAA*
*A*A*A*AA****
*A*AAA*A*AAA*
*A*****A*A*A*
*AAAAAAAAA*A*
*************