*********
*PAAAAAA*
*A*AA****
*A*A*AAG*
*A*AAA***
*AAA*A*A*
*A*A*A*A*
*A*AAAAA*
*********