*************
*P*AAAAAAAAA*
*A*A*A*****A*
*A*A*AAAAA*A*
*A*A*****A***
*A*AAAAA*AAA*
*A**A**A***A*
*AAAAA*AAAAA*
*A***A***A*A*
*AAAAA*AAA*A*
*A*****A***A*
*AAAAAAAAA*G*
*************