*********
*PAA*AAA*
*A*A*A*A*
*AAAAA*A*
*AA*AA*A*
*AAA*AAA*
*A**AA*A*
*A*GAAAA*
*********