*************
*PAAAAAAAAAA*
***AA****A*A*
*GAAAAAA*A*A*
*****A*A*A***
*AAAAA*A*AAA*
*****A*A***A*
*AAAAAAA*AAA*
*AA**A*A*A*A*
*AAA*A*A*A*A*
*A*A***A*A*A*
*A*AAAAAAA*A*
*************