*************
*PAAAA*AAAAA*
****AAAA*A*A*
*AAAAA*G*A*A*
*AA**A**AA*A*
*AAAAA*AAAAA*
*AAA*AAA*A***
*A*AAAAA*AAA*
*AA***A****A*
*AAAAA*AAA*A*
*A***AAA*A*A*
*AAA*AAA*AAA*
*************