*********
*PAAAAAA*
*A*A*****
*A*A*AAA*
*AAAAA*A*
*AAA*A*G*
*A*A*A***
*AAAAAAA*
*********