*********
*PAAAAAA*
*A*****A*
*AAA*GAA*
***A***A*
*AAAAAAA*
*A*A*AAA*
*AAAAAAA*
*********