*************
*P*AAAAA*AAA*
*A*A***A*A*A*
*A*AAA*A*AAA*
*AA**A*A***A*
*AAA*GAAAA*A*
***A*****A*A*
*AAAAAAA*AAA*
*A*****A***A*
*AAAAA*AAA*A*
*AA**AA****A*
*AAA*AAAAAAA*
*************