*************
*PAAAA*AAAAA*
**AA*A*A*A*A*
*AAAAA*A*AAA*
*A**AA*****A*
*AAAAAAAAA*A*
**AA***AAA*A*
*AAAAAAA*A*A*
*A***A*AAA*A*
*A*AAAAAAA*A*
*A*A***A***A*
*GAAAAAAAAAA*
*************