*************
*PAAAAAAAAAA*
*A***A*****A*
*AAAAAAA*A*A*
*******A*A*A*
*AAAAAAAAA*A*
*A*AA*A**A*A*
*A*AAAAA*A*A*
*A*****A***A*
*AAG*A*A*AAA*
****AA*A*A*A*
*AAAAAAAAA*A*
*************