*************
*PAA*GAAAAAA*
*A*AA******A*
*A*AAAAA*AAA*
*A*****A*AA**
*A*A*AAA*AAA*
*A*A*A*AA**A*
*A*A*AAA*AAA*
*A*AAAAA*A***
*AAA*A*A*AAA*
***A*AA****A*
*AAA*AAAAAAA*
*************