*********
*PAAAA*A*
*A**AA*A*
*A*AAA*A*
*A*AA**A*
*A*G*AAA*
*A***A*A*
*AAAAAAA*
*********