*********
*PAAAAAA*
*AA**A*A*
*GAAAA*A*
*******A*
*AAAAAAA*
*A*A*****
*AAAAAAA*
*********