*********
*PAA*AAA*
*A*A*A*A*
*G*A*A*A*
*A*A***A*
*A*AAAAA*
*AAA*A*A*
*AAAAAAA*
*********