*********
*GPAAAAA*
***A**AA*
*AAAAA*A*
*A***AAA*
*A*AAA*A*
*A*A***A*
*A*AAAAA*
*********