*************
*P*AAA*A*AAA*
*A*A*A*A*A*A*
*A*A*A*AAA*A*
*AAA*A*****A*
*A*GAA*AAAAA*
*A***A*A***A*
*AAA*A*A*AAA*
*AAA*A*A*A*A*
*A*A*AAA*AAA*
*A*AAA*A*A*A*
*AAAAAAAAAAA*
*************