*************
*PAG*AAAAAAA*
*A*****A*A*A*
*AAAAA*A*A*A*
*****A*A*A*A*
*AAAAAAA*A*A*
*A***A***A*A*
*AAA*AAAAA*A*
*A*A*******A*
*A*AAAAAAA*A*
*AA****A*A*A*
*AAAAA*AAAAA*
*************