*********
*PAA*G*A*
*A*A*A*A*
*A*AAAAA*
*A*****A*
*AAAAAAA*
*A***A***
*AAAAAAA*
*********