*************
*PAAAAAAAAAA*
*AA****A***A*
*A*AAA*AAA*A*
*AA**A***A*A*
*AAAAAAAAA*A*
**AA*A*A*A***
*A*AAA*A*AAG*
*A***A***A*A*
*AAAAA*AAA*A*
*AA****A***A*
*AAAAA*AAAAA*
*************