*************
*PAAAAAAAAAA*
*A*A***A*A*A*
*A*AAAAA*AAA*
*A****A*AA***
*AAA*AAA*AAA*
***A*A*A*AAA*
*A*AAAAA*A*G*
*AA**A*A*A***
*AAA*AAA*AAA*
*A***A*AA**A*
*AAAAAAAAAAA*
*************