*************
*P*AAAAAAAAA*
*A*A*****A*A*
*A*A*AAA*AAA*
*AAA*A*A***A*
*AAA*A*AAAAA*
*A***A*****A*
*AAA*AAA*AAA*
***A***A*A***
*A*AAA*A*AAA*
*A*A***AA**A*
*AAA*GAA*AAA*
*************