*************
*PAA*AAAAAAA*
*A*A*******A*
*A*AAAAAAA*A*
*A***A***A*A*
*AAA*A*G*A*A*
*A*A***A*A*A*
*A*A*AAA*AAA*
**AA*A*******
*AAA*AAAAAAA*
*A*********A*
*AAAAAAAAAAA*
*************