*********
*PAAAAAA*
*A*A*****
*A*AAAAA*
*******A*
*AAAAAAA*
*A***A*A*
*AAG*AAA*
*********