*************
*PAAAAAAAA*A*
*A***A*A*A*A*
*AAAAAAA*AAA*
****A**A***A*
*AAA*A*A*AAA*
*A*AAA*AA**A*
*AAA*AAAAAAA*
*A*A*A**AA*A*
*A*AAAAA*G*A*
*AA***AA***A*
*AAAAAAAAAAA*
*************