*************
*P*GAA*AAAAA*
*A***A***AAA*
*AAA*A*AAA*A*
*A***A*A*A*A*
*AAA*A*AAAAA*
***A*A*A*A***
*AAA*A*A*AAA*
*A***A****AA*
*AAAAA*AAA*A*
*A**A**A*A*A*
*AAAAAAA*AAA*
*************