*********
*PAG*AAA*
*A*****A*
*A*AAAAA*
*A*A*A*A*
*A*A*A*A*
*A***A*A*
*AAAAA*A*
*********