*********
*PAA*AAA*
*A*A*A*A*
*G*AAA*A*
******AA*
*AAAAAAA*
*A*****A*
*AAAAAAA*
*********