*********
*PAA*GAA*
*A*A***A*
*AAAAAAA*
*A*AA****
*A*AAA*A*
*A*A*A*A*
*AAA*AAA*
*********