*********
*P*AAAAA*
*A*AA**A*
*AAAAA*A*
*A*A***A*
*A*AAA*A*
*A*A*AAA*
*A*G*AAA*
*********