*************
*PAAAA*AAAAA*
*A*AAA*AAA***
*A*AAAAAAAAA*
*A*A*******A*
*AAAAA*AAA*G*
*****AA**A***
*AAA*AAA*AAA*
*A**A**A*A***
*AAAAA*A*AAA*
*A*A***A***A*
*A*AAAAAAAAA*
*************