*************
*PAAAAAAAAAA*
*******A*AAA*
*AAAAAAA*AAA*
*A***A*****A*
*AAA*AAAAAAA*
***A***A*AA**
*AAA*AAA*AAA*
*A***A****AA*
*A*AAAAA*AAA*
*A*A*****A*A*
*AAAAAAGAA*A*
*************