*********
*PAAAAAA*
*A*****A*
*A*A*AAA*
*A*AAA***
*G*A*A*A*
**AAAA*A*
*AAAAAAA*
*********