*********
*PAAAAAA*
*A***AAA*
*A*G*AAA*
*A*A***A*
*A*AAA*A*
*A***A*A*
*AAAAAAA*
*********