*********
*PAAAAAA*
*A*****A*
*AAAAAAA*
*A*******
*A*AAAAG*
*A*A**A**
*AAAAAAA*
*********