*************
*PAAAAAAAAAA*
*A*A*A***AA**
*AAA*AAA*AAA*
*AAA**AAA**A*
*A*A*AAAAAAA*
***A***A***A*
*AAA*AAAAG*A*
*A*AAA****AA*
*AAA*A*AAAAA*
*A*A*A*A*A***
*A*AAA*AAAAA*
*************