*********
*PAA*AAA*
*A*A*A*A*
*A*G*AAA*
*A*****A*
*A*AAAAA*
*AAA*A*A*
*AAAAAAA*
*********