*********
*PAA*AAA*
*AA**A*A*
*AAAAA*G*
*A*******
*AAA*AAA*
***A**AA*
*AAAAAAA*
*********