*************
*PAA*AAG*AAA*
*A*A*A***AAA*
*A*A*AAA*AAA*
*A*A*A*A*A*A*
*A*AAA*AAA*A*
***A*A*****A*
*AAAAA*AAAAA*
*A*****A*****
*A*AAA*A*AAA*
*A*A*A*A*A*A*
*AAA*AAAAA*A*
*************