*************
*PAAAAAA*AAA*
*A*A***A*A*A*
*A*AAAAA*A*A*
*A**AAAAAAAA*
*AAAAA*AAA*G*
*A***A***A*A*
*A*AAAAAAAAA*
*A*A***A*A***
*AAA*A*AAA*A*
**AA*A****AA*
*AAAAAAAAAAA*
*************