*************
*PAAAAAAAAAA*
******AA***A*
*AAAAA*AAA*A*
*A***A*A*A*A*
*A*AAA*A*A*A*
*A*A*****A*A*
*A*AAAAAAA*A*
*AA**A*****A*
*G*AAAAAAAAA*
***A***AAA*A*
*AAAAAAAAAAA*
*************