*************
*PAAAAAAAAAA*
*A*****A***A*
*AAAAA*A*A*A*
*******A*A*A*
*AAA*AAA*AAA*
*A*A*A***A*A*
*G*AAA*A*A*A*
*******A*A*A*
*AAAAAAA*A*A*
*A*AA****A*A*
*A*AAAAAAAAA*
*************