*************
*PAAAAAAAAAA*
*A******AA*A*
*A*A*AAAAA*A*
*A*A*A*A**A**
*AAA*A*A*AAA*
*****A*AAA*A*
*AAAAA*A*A*A*
*A*******A*A*
*AAAAAAA*A*A*
*A***A*A*A*A*
*AAAAA*AAA*G*
*************