*************
*PAA*AAAAAAA*
*AAA**A**A*A*
*A*AAAAA*A*A*
*A***A*A*A*A*
*A*AAAAAAAAA*
*A*A******A**
*A*AAAAAAAAA*
*A*****A***A*
*A*AAA*G*AAA*
*A*A*A***A*A*
*AAA*AAAAAAA*
*************