*********
*GPAAAAA*
*A***AAA*
*A*AAAAA*
*A*A*A*A*
*AAA*AAA*
*A**A****
*AAAAAAA*
*********