*********
*PAA*AAG*
*A*A*A***
*A*A*AAA*
*AAA***A*
*A*AAAAA*
*A***A*A*
*AAAAAAA*
*********