*********
*PAAAAAA*
*****A*A*
*AAAAG*A*
*A***A*A*
*AAAAAAA*
***A***A*
*AAAAAAA*
*********