*************
*PAAAA*G*AAA*
*A*****A*A*A*
*AAAAAAA*A*A*
*A*A*****A*A*
*A*A*AAAAA*A*
*AAA****AA***
*A*AAAAA*AAA*
*AA****AAA*A*
*AAAAA*A*AAA*
*AA***AA*A*A*
*AAAAAAAAAAA*
*************