*********
*GPAAAAA*
**AA**AA*
*AAA*AAA*
***A*A***
*AAA*AAA*
*AA****A*
*AAAAAAA*
*********