*************
*PAAAG*AAAAA*
*A*****A***A*
*A*A*AAA*AAA*
*A*A*A***A*A*
*A*AAAAA*AAA*
*A*A*A***AAA*
*A*A*AAA*A*A*
*AA**A*A*A*A*
*AAA*A*A*A*A*
***A*A*AAA*A*
*AAAAA*AAA*A*
*************