*********
*PAAAAAA*
*A*A***A*
*A*AAAAA*
*A*******
*A*AAA*G*
*AAA*A*A*
*AAA*AAA*
*********