*************
*PAA*AAAAAAA*
*A***A**A**A*
*AAAAA*AAA*A*
*A*A*A*A*A*A*
*AAAAAAA*AAA*
***A*A*A***A*
*AAA*AAA*G*A*
*AAA*****A*A*
*A*A*AAAAA*A*
*A***A*A*AAA*
*AAAAA*AAA*A*
*************