*********
*PAAAAAA*
*A***A*A*
*AAAAA*A*
*A*A*****
*A*A*GAA*
*AAA***A*
*AAAAAAA*
*********