*********
*PAA*AAA*
*A*A**AA*
*A*AAA*A*
*A***A*A*
*AAG*AAA*
**A*AA*A*
*AAAAAAA*
*********