*************
*P*AAG*AAAAA*
*A*A***A*A*A*
*AAA*AAA*AAA*
*A*A*A**A**A*
*AAA*A*AAA*A*
*A***AAA*A*A*
*AAAAA*A*AAA*
*****A*A***A*
*AAA*AAAAAAA*
*A*A*A*A*A***
*A*AAA*AAAAA*
*************