*********
*PAG*AAA*
*A***A***
*AAA*AAA*
**AA***A*
*A*AAAAA*
*AA****A*
*AAAAAAA*
*********