*********
*PAAAAAA*
*A****AA*
*AAAAAAA*
*A*****A*
*A*AAAAA*
**AA***A*
*GAA*AAA*
*********