*********
*PAAAAAA*
*A**A**A*
*A*A*AAA*
*A*A*A*A*
*AAA*AAA*
***A*AA**
*AAAAAAG*
*********