*************
*PAAAAAA*AAA*
*A**AA*A*A*A*
*AAA*A*A*A*A*
*****A*A*A*A*
*AAA*A*A*A*A*
*A*A*A*A*A*A*
*A*AAA*AAA*A*
*A***A*A*****
*AAA*A*AAAAA*
*A*A***A*A*A*
*A*AAAAAAA*G*
*************