*********
*PAAAAAA*
*A*****A*
*A*AAA*A*
*AA**A*A*
*AAAAAAA*
***A*A*A*
*GAA*AAA*
*********