*************
*PAA*AAAAAAA*
*A***AAA***A*
*AAAAA*A*AAA*
*A*****A*A***
*A*AAA*A*A*A*
***A*A*A*A*A*
*AAAAAAA*AAA*
*A**A**A*A*A*
*AAAAAAA*AAA*
*A*****AA**A*
*AAAAA*AAG*A*
*************