*********
*P*AAAAA*
*A*A**AA*
*AAAAA*A*
*A****AA*
*A*AAAAA*
*A*A***A*
*A*AAGAA*
*********