*************
*P*AAAAAAA*A*
*A*A*****A*A*
*AAA*AAAAA*A*
*A*AAA*****A*
*A*GAA*A*AAA*
*A*****A*A*A*
*A*AAAAAAA*A*
*A**A******A*
*A*AAAAAAAAA*
*A*A***A*AAA*
*AAA*AAAAAAA*
*************