*********
*PAAAAAA*
*A*****A*
*A*AAAAA*
*A*A***A*
*A*A*A*A*
*A*A*A*A*
*A*G*AAA*
*********