*************
*PAAAAAA*AAA*
*AA***AA*A***
*AAAAG*A*AAA*
******AAAA*A*
*AAAAA*A*A*A*
***A***A*A*A*
*AAA*AAAAA*A*
*A*A*A**A**A*
*AAA*A*AAAAA*
*A***A*A***A*
*AAAAAAA*AAA*
*************