*************
*PAAAA*AAAAA*
*A***A*A*A*A*
*AAAAAAA*A*A*
*A****A**A*A*
*AAA*AAAAA*A*
***A*A*A*A***
*AAA*A*A*A*G*
*AA**A*AAAAA*
*A*AAA*AAA*A*
*A*A*******A*
*A*AAAAAAAAA*
*************