*********
*PAAAA*A*
*A*A*AAA*
*A*A*AAA*
*A*A*****
*AAA*AAA*
*A*A*A*A*
*A*AAA*G*
*********