*********
*PAAAAAA*
*A**A**A*
*AAAAG*A*
*A*A*AAA*
*A*A*AAA*
*A*A*A*A*
*A*AAA*A*
*********