*************
*PAA*AAAAAAA*
*A*AAA*A***A*
*A*A*A*AAAAA*
***A*A***A*A*
*AAA*AAAAGAA*
*A*AA***A**A*
*AAAAA*AAA*A*
*A***A*A*A*A*
*A*AAA*A*A*A*
*AAA*AAA*A*A*
*A*AAAAAAAAA*
*************