*********
*PAAAAAA*
*A*A*****
*A*A*AAA*
*A*A*A*A*
*AAAAA*A*
*AAA***A*
*AAA*GAA*
*********