*************
*PAAAA*AAAAA*
*A***A***AAA*
*A*AAAAAAAAA*
*A*A*A*A***A*
*A*AAAAA*AAA*
*A*A**A****A*
*AAAAAAAAA*A*
*******A*AAA*
*AAAAAAA*GAA*
*A*A*A*A***A*
*A*AAA*AAAAA*
*************