*************
*P*AAAAAAAAA*
*A*A***A*****
*AAAAA*AAAAG*
*AA**A*****A*
*AAA*AAAAAAA*
*A*********A*
*A*AAAAAAA*A*
*A*A*A*A*A*A*
*AAAAAAA*AAA*
*A*****AAA***
*AAAAA*AAAAA*
*************