*************
*PAAAA*AAAAA*
***A*A***A***
*AAA*AAA*AAA*
*A*****A***A*
*AAA*AAAAAAA*
*AAA*A***A*A*
*AAA*A*AAA*A*
*A***AAA*A***
*AAAAA*A*AAG*
*A*A***A*****
*A*AAAAAAAAA*
*************