*********
*PAAAAAA*
*A*****A*
*AAAAA*A*
*A*A*A*A*
*AAA*A*A*
*A***A*A*
*A*GAAAA*
*********