*********
*PAAAAAA*
*A*****A*
*AAA*GAA*
***A*AA**
*AAA*AAA*
*A***A*A*
*AAAAA*A*
*********