*********
*PAA*AAA*
***AAA*A*
*G*AAA*A*
*A*****A*
*AAA*AAA*
***A*A*A*
*AAAAAAA*
*********