*********
*GPAAAAA*
*AAA**AA*
*AAAAA*A*
*AA**A*A*
*AAA*AAA*
***A*A*A*
*AAAAA*A*
*********