*************
*PAAAAAA*AAA*
*A*A*A*A*A*A*
*AAAAAAAAA*A*
***A*******A*
*AAA*GAAAA*A*
*********A*A*
*AAA*AAAAA*A*
*A*A*A*****A*
*A*AAA*AAA*A*
*AA***AA*A*A*
*AAAAAAAAAAA*
*************