*********
*P*AAAAA*
*A*AA*AA*
*A*AAG*A*
*A*****A*
*AAA*AAA*
*A*A*A***
*A*AAAAA*
*********