*********
*PAAAAAA*
*A**A**A*
*A*GAA*A*
*A*A*A*A*
*AAAAA*A*
*****AAA*
*AAAAAAA*
*********