*********
*G*PAA*A*
*A*A*A*A*
*A*A*AAA*
*A*AAAAA*
*AAA*A*A*
*****AAA*
*AAAAAAA*
*********