*********
*PAAAAAA*
*A*A**AA*
*A*A*AAG*
*A**AA***
*A*AAAAA*
*A*A***A*
*AAAAAAA*
*********