*************
*PAAAAAAAAAA*
*AAA***A**AA*
*A*AAAAAAA*A*
*****A***A*A*
*AAA*A*AAA*A*
*A*A***A***A*
*AAA*AAA*AAA*
*A*A*A***AAA*
*A*AAA*AAAAA*
*A***A*A***A*
*G*AAAAAAAAA*
*************