*********
*P*AAAAA*
*A*A***A*
*AAA*AAA*
*A*A*A*A*
*GAAAA*A*
*******A*
*AAAAAAA*
*********