*************
*P*AAAAAAAAA*
*A*A**AA***A*
*AAAAAAA*AAA*
*A*******A*A*
*AAA*AAAAA*A*
*A***A*****A*
*A*AAA*AAG*A*
*A*A***A***A*
*A*AAA*A*AAA*
*A***A*AAA***
*AAA*AAA*AAA*
*************