*************
*PAAAAAAAAAA*
*AA******A***
*A*AAAAA*AAA*
*A*****A***A*
*AAAAA*AAAAA*
*****A*AAA*A*
*AAAAAAA*AAA*
***********A*
*AAAAA*AAAAA*
*A***A*A***A*
*AAG*AAA*AAA*
*************