*********
*PAAAAAA*
***A***A*
*AAAAAAA*
*A*A***A*
*A*A*G*A*
*AA**A*A*
*AAAAA*A*
*********