*********
*PAAAAAA*
*A**AA*A*
*AAA*A*A*
*AAA*A*A*
*AAAAAAA*
*A*A***A*
*G*AAAAA*
*********