*********
*PAAAA*A*
*A*A*AAA*
*A*A*AAA*
*AAA*****
*A*AAAAG*
*A*******
*AAAAAAA*
*********