*************
*PAAAA*AAAAA*
*AA**A***A*A*
*A*A*AAAAA*A*
*A*A***A*****
*A*AAAAAAAAA*
*A*A*A*A*A*A*
*A*AAA*AAA*A*
*A*AAA*A*AAA*
*AAA*A*A*GAA*
*A**AA*****A*
*AAA*AAAAAAA*
*************