*************
*P*AAAAAAAAA*
*A*A*****A*A*
*A*AAA*AAA*A*
*AA**A*A***A*
*AAAAA*AAAAA*
*******A*****
*AAAAAAAAAAA*
*AAA*A*****A*
*AAA*A*AAAAA*
***AAA*A***A*
*GAA*AAA*AAA*
*************