*************
*PAA*AAAAAAA*
*A*A*A***A*A*
*A*AAAAAAA*A*
*******A*A***
*G*AAA*AAAAA*
*AAA*A**A**A*
*A*AAAAAAAAA*
*AAA***AAA*A*
*A*AAAAAAA*A*
*A***A*A*A*A*
*AAAAA*AAAAA*
*************