*********
*PAAAAAA*
*A****AA*
*AAAAA*A*
*A*A*A*A*
*GAAAAAA*
***A**A**
*AAAAAAA*
*********