*********
*PAAAAAA*
*A*A*AAA*
*AAAAG*A*
*AA*A**A*
*A*AAAAA*
*A*****A*
*AAAAAAA*
*********