*************
*PAAAAAAAAAA*
*A*****A***A*
*A*AAAAAAA*A*
*A*A*****A***
*A*AAAAAAAAA*
*AA**A*A***A*
*AAAAA*GAAAA*
**A**A*A*****
*AAA*AAAAAAA*
*A*A*******A*
*A*AAAAAAAAA*
*************