*************
*PAA*AAAAG*A*
*A*A*A***A*A*
*A*AAA*AAAAA*
*A**A****A*A*
*A*AAAAA*A*A*
*A*AAA*AAA*A*
*A*AAA*A*AAA*
*A*A***A*A*A*
*A*A*AAA*A*A*
*AAA*A****AA*
*AAA*AAAAAAA*
*************