*************
*PAAAAAAAAAA*
*A***A*A***A*
*AAA*A*A*AAA*
***A*AAA***A*
*A*AAA*A*GAA*
*A***A*A***A*
*AAAAA*AAA*A*
*AA****AA**A*
*AAA*AAA*AAA*
***A*A***A*A*
*AAA*AAAAAAA*
*************