*************
*PAAAAAA*AAA*
*A**AA*A*A*A*
*A*AAAAAAAAA*
*A*A*******A*
*A*A*A*AAAAA*
*A*A*A*A*****
*A*A*AAAAAAG*
*A*A*****A***
*A*AAAAAAA*A*
*A***A*A***A*
*AAA*AAAAAAA*
*************