*************
*PAAAA*GAAAA*
*A*AA****A*A*
*A*AAAAAAA*A*
****AA*A***A*
*AAAAA*AAAAA*
*A***A***A***
*AAAAAAA*A*A*
*A*A***A*A*A*
*AAAAA*AAA*A*
*A***A*AA**A*
*AAAAAAAAAAA*
*************