*********
*PAAAA*G*
*A***A*A*
*AAAAA*A*
*A*****A*
*AAAAAAA*
*A**A*A**
*AAAAAAA*
*********