*************
*PAAAAAAAA*A*
*A****A*AA*A*
*AAAAA*AAAAA*
*A***A*****A*
*AAA*A*AAA*A*
***A*A*A*A*A*
*AAA*A*A*A*A*
*A**AAAA*A*A*
*A*AAA*AAA*A*
*A*A***A*A*A*
*A*AAAAA*G*A*
*************