*********
*P*AAGAA*
*A*A**AA*
*AAA*AAA*
*AA****A*
*A*AAAAA*
*A*A***A*
*AAAAAAA*
*********