*********
*PAA*AAA*
*A*AA**A*
*A*AAAAA*
*A***A*A*
*A*GAA*A*
*A****AA*
*AAAAAAA*
*********