*********
*PAA*AAA*
*A*AA**A*
*A*AAAAA*
*A****AA*
*AAGAA*A*
****AA*A*
*AAAAAAA*
*********