*********
*P*G*AAA*
*A*A*A*A*
*A*AAA*A*
*A*A*A***
*AAA*AAA*
*A*****A*
*AAAAAAA*
*********