*************
*PAA*GAAAAAA*
*A***A*A*A*A*
*AAAAA*A*A*A*
*A*****A*A***
*A*AAAAA*AAA*
*A*A*******A*
*AAAAAAA*AAA*
****AA*A*A*A*
*AAAAA*AAA*A*
*A***A*****A*
*AAA*AAAAAAA*
*************