*************
*PAAAAAAAAAA*
*AA**A***A*A*
*A*AAA*A*AAA*
*A*A*AAA*A*A*
*AAA*G*AAA*A*
*******A*A*A*
*AAA*AAA*AAA*
*A*A*A*AA**A*
*A*AAA*AAA*A*
*A*A*A***A*A*
*A*AAAAA*AAA*
*************