*********
*P*AAAAA*
*AAAA*AA*
*AAAAAAA*
*A*A***A*
*AAA*AAA*
*A***A*A*
*AAAAAAG*
*********