*********
*PAAAA*A*
***AAA*A*
*AAA*AAA*
*A*******
*A*GAAAA*
*A**A**A*
*AAAAAAA*
*********