*************
*PAA*AAAAAAA*
*A*A*A***A*A*
*AAAAAAA*A*A*
*********A*A*
*AAAAG*AAA*A*
*A*A***AA**A*
*AAA*AAA*AAA*
***A*A*A*A***
*A*A*A*A*AAA*
*A*A***A***A*
*AAAAAAA*AAA*
*************