*********
*PAA*AAA*
*A*A*AAA*
*A*AAA*G*
*A*A*****
*AAA*AAA*
***A***A*
*AAAAAAA*
*********