*********
*PAAAAAA*
*A*A***A*
*A*GAA*A*
*A***A*A*
*AAA*AAA*
*AA*AA*A*
*AAAAA*A*
*********