*************
*PAA*AAA*AAA*
*AAA*A*AA**A*
*AAA*A*AAAAA*
*A*A*AA****A*
*A*A*GAAAAAA*
*A*A***A*****
*A*AAA*A*AAA*
*A***A*A*A*A*
*A*AAAAA*A*A*
*AAA****AA*A*
*AAAAAAAAA*A*
*************