*********
*P*GAAAA*
*A*A***A*
*AAA*AAA*
*A***A***
*A*AAA*A*
*A*A***A*
*AAAAAAA*
*********