*********
*P*AAA*A*
*A*A*A*A*
*A*A*A*A*
*A*A*A*A*
*A*A*G*A*
*A*A***A*
*AAAAAAA*
*********