*************
*PAAAAAAAAAA*
*A****A****A*
*AAAAAAAAA*A*
*A**AA***A***
*A*AAA*G*AAA*
*A*A***AA**A*
*AAA*AAA*AAA*
***A*A*A*A*A*
*A*A*A*AAA*A*
*AAA*A*AA**A*
*AAA*AAA*AAA*
*************