*********
*PAAAAAA*
***A*A*A*
*GAAAA*A*
*A*A*AAA*
*A*AAA*A*
*A*AA**A*
*AAA*AAA*
*********