*********
*PAAAA*A*
*A***AAA*
*A*AAAAA*
*A*****A*
*A*GAA*A*
*A***A*A*
*AAAAAAA*
*********