*********
*PAAAAAA*
*A**A****
*AAAAAAA*
*A*****A*
*AAA*AAA*
*A*A*AAA*
*AAGAA*A*
*********