*********
*PAAAAAA*
*AA**AAA*
*A*AAAAA*
*A*A*A*A*
*AAA*GAA*
*A*AA**A*
*AAAAAAA*
*********