*********
*PAAAAAA*
***A*A*A*
*AAA*A*A*
*A*A*A*A*
*AAG*A*A*
*****AAA*
*AAAAAAA*
*********