*********
*GPA*AAA*
***A*A*A*
*A*AAAAA*
*A***AAA*
*AAAAA*A*
*A**A**A*
*AAAAAAA*
*********