*********
*PAAAAAA*
*A*A***A*
*AAAAA*A*
**A**A*A*
*AAGAA*A*
*AA**A*A*
*AAAAA*A*
*********