*********
*PAAAAAA*
*A*A***A*
*G*AAAAA*
*A***A*A*
*AAA*AAA*
**AA*A*A*
*AAAAAAA*
*********