*********
*PAAAA*A*
***A*A*A*
*AAAAA*A*
*A***A*A*
*G*AAA*A*
***A*A*A*
*AAAAAAA*
*********