*********
*PAAAAAA*
***A***A*
*AAA*A*A*
*A**AA*A*
*A*GAAAA*
*A*A*A***
*AAA*AAA*
*********