*********
*PAAAA*A*
*A***A*A*
*AAAAAAA*
*A**A****
*AAAAGAA*
*A*A***A*
*A*AAAAA*
*********