*********
*P*AAAAA*
*A*A*A*A*
*AAA*AAA*
*A***A*A*
*AAA*A*A*
*A**AA*A*
*AAGAAAA*
*********