*************
*PAAAAAAAAAA*
*A*****A*AAA*
*A*AAA*A*AAA*
*A*A*A***A*A*
*AAA*AAAAAAA*
*A**A******A*
*A*AAAAAAA*A*
*A*AA****A***
*AAA*AAG*AAA*
*A***A*****A*
*AAA*AAAAAAA*
*************