***********
*PG       *
*         *
*         *
*         *
*         *
*         *
*         *
*         *
*    G    *
***********