*********
*P*AAAAA*
*A*A*A*A*
*AAA*AAA*
*AAA*AAA*
*A*AAA*A*
*A*A***A*
*A*GAAAA*
*********