*********
*PAAAAAA*
*A***A*A*
*A*AAA*A*
*A*A*A***
*AAA*A*G*
*A*AA**A*
*A*AAAAA*
*********