*************
*PAAAAAAAAAA*
***A*****A***
*G*AAAAA*AAA*
*A*********A*
*AAAAA*AAA*A*
**A**A*AAA*A*
*AAAAAAA*AAA*
*AAA***A*A*A*
*AAAAAAA*AAA*
*****A*****A*
*AAAAAAAAAAA*
*************