*********
*PAA*AAA*
*A*A*A*A*
*A*AAAAG*
*A***A*A*
*AAAAA*A*
*A*A***A*
*AAAAAAA*
*********