*************
*P*AAAAA*AAA*
*A*A**AA*AAA*
*A*AAA*G*AAA*
*A***A***AAA*
*AAAAA*AAAAA*
*A*A***A***A*
*A*A*AAAAA*A*
*A*A****AA*A*
*A*AAAAAAA*A*
*A******A**A*
*AAAAAAAAAAA*
*************