*************
*PAAAAAAAAAA*
*A*********A*
*AAAAAAAAAAA*
*A*A*****A*A*
*AAAAAAA*A*A*
*AA*AA*A*AAA*
*AAAAA*AAA*A*
*****AAAA**A*
*A*AAA*A*G*A*
*A*A***A*A*A*
*AAAAA*AAA*A*
*************