*********
*PAAAAAA*
*A*AA*AA*
*AAAAA*A*
**A****A*
*G*AAAAA*
*A*A***A*
*AAA*AAA*
*********