*************
*P*AAAAAAA*A*
*A*A*A***AAA*
*AAA*A*A*A*A*
***A*A*A*A*A*
*AAAAA*AAAAA*
*A*****A*****
*AAA*AAA*AAG*
*A*A*****A***
*A*A*AAAAAAA*
*A*A*A*****A*
*A*AAAAAAAAA*
*************