*************
*PAAAA*AAAAA*
*AA**AAA*A*A*
*A*AAA*AAA*A*
*A*A*****A*A*
*A*AAAAAAAAA*
*A***A*A*****
*G*AAA*AAAAA*
***AAA*****A*
*AAA*AAAAA*A*
*A**A**A*A*A*
*AAAAAAA*AAA*
*************