*********
*P*AAAAA*
*A*A**AA*
*AAA*AAA*
*A*AAA*A*
*A*AAAAA*
*A***A*A*
*AAAAAAG*
*********