*************
*PAAAAAAAAAA*
*A*AA**AA**A*
*AAA*AAAAA*A*
**AA*AA**A*A*
*AAAAA*AAAAA*
*A***A*AAA*A*
*A*AAA*AAAAA*
*A*A****AAAA*
*A*A*AAAAAAG*
*A*AAA*A*A***
*AAAAA*AAAAA*
*************