*********
*PAAAAAA*
*A***A***
*A*AAA*G*
*A****AA*
*AAAAAAA*
*AA******
*AAAAAAA*
*********