*************
*PAAAA*AAAAA*
*A***A*AAA*A*
*AAA*A*AAAAA*
***A*A*A***A*
*AAA*A*A*A*A*
*****A*A*A*A*
*AAAAA*AAAAA*
*A***A*A***A*
*A*AAA*AAG*A*
*A********AA*
*AAAAAAAAAAA*
*************