*************
*PAA*AAAAA*A*
*AAA**AA*A*A*
*A*AAAAAAAAA*
*A*********A*
*AAAAG*AAA*A*
****A**A*A*A*
*AAA*AAA*AAA*
*A*A*A***A***
*A*AAAAAAAAA*
*AA****A*A*A*
*AAAAAAA*AAA*
*************