*************
*PAAAA*AAG*A*
***AAA*AA**A*
*AAA*A*AAAAA*
*A*********A*
*AAAAAAAAAAA*
*A***A*A*****
*A*AAA*AAAAA*
*A*A*******A*
*A*AAA*AAA*A*
*A***A*A*A*A*
*AAA*AAA*AAA*
*************