*********
*PAAAAAA*
*A***A***
*AAA*AAA*
***A***A*
*AAAAA*A*
*A*A***A*
*AAAAGAA*
*********