*********
*PAAAAAA*
*A*******
*AAAAAAG*
***AAA***
*AAA*A*A*
*A***A*A*
*AAAAAAA*
*********