*************
*PAAAAAAAA*A*
*A*A****AA*A*
*A*AAA*A*AAA*
*A***A*A***A*
*GAAAA*AAA*A*
*A*****A*AAA*
*AAAAAAAAA*A*
*AA****A*A*A*
*AAAAAAA*AAA*
*AA**********
*AAAAAAAAAAA*
*************