*************
*PAG*AAAAAAA*
*A***A*A*A*A*
*A*AAAAA*AAA*
*A*****A***A*
*AAAAAAA*AAA*
*A*A*A***A***
*AAA*AAA*A*A*
*****A***A*A*
*AAAAAAAAAAA*
*A***A*AA**A*
*AAAAAAAAAAA*
*************