*************
*PAAAAAA*AAA*
*****A***AAA*
*AAAAA*AAA*G*
*A*A***A*****
*A*A*AAA*AAA*
*A*A*AA**A*A*
*A*A*AAAAAAA*
*A*A*A*****A*
*AAA*AAAAA*A*
*A***AAAA**A*
*AAAAA*AAAAA*
*************