*************
*PAA*AAAAAAA*
*A*A*A***A***
*A*A*AAA*AAA*
*A*A***A***A*
*AAA*AAA*GAA*
***A*AA***A**
*AAAAAAA*AAA*
*A***A*A*A***
*AAAAAAA*AAA*
*A********AA*
*AAAAAAAAAAA*
*************