*********
*PAAAAAA*
*A*******
*A*AAA*G*
*A*A*A*A*
*A*A*A*A*
*A*A*A*A*
*AAAAAAA*
*********