*********
*PAAAAAA*
*A*****A*
*A*GAA*A*
*A*A*A***
*AAAAAAA*
*A*AAA*A*
*A*AAAAA*
*********