*********
*PAAAAAA*
*****A***
*AAG*AAA*
*A*****A*
*AAAAA*A*
**A**A*A*
*AAAAAAA*
*********