*********
*PAA*AAA*
*A***A*A*
*AAAAA*A*
***A*A*A*
*AAA*G*A*
*A*****A*
*AAAAAAA*
*********