*************
*PAAAAAAAAAA*
*A*******A*A*
*AAAAAAA*A*A*
*****A***A*A*
*AAA*A*G*AAA*
*A*AAA*A*AAA*
*AAA*A*A*A*A*
*A***A*A*A*A*
*A*AAAAAAA*A*
*AAA*****A*A*
*AAAAAAA*AAA*
*************