*************
*PAAAA*AAAAA*
*A***A*A***A*
*AAAAAAA*A*A*
*A**A****A*A*
*AAAAA*AAA*A*
**AA*A*A*A*A*
*AAA*AAA*A*A*
*A*A*A*****A*
*A*A*A*AAAAA*
*AA**A*AA**A*
*AAAAA*G*AAA*
*************