*********
*P*GAA*A*
*AA**A*A*
*AAAAA*A*
*A*A*A*A*
*A*AAA*A*
*A****AA*
*AAAAAAA*
*********