*************
*PAA*AAAAA*G*
*A***A***A*A*
*AAAAA*AAA*A*
*******AAA*A*
*AAAAAAA*AAA*
*A*******A*A*
*A*AAAAAAA*A*
*AA****A***A*
*AAAAAAAAAAA*
*A***AA****A*
*AAA*AAAAAAA*
*************