*************
*PAAAAAAAAAA*
*AA**AA****A*
*A*AAAAAAAAA*
*A*A***A*AAA*
*AAAAA*AAA*A*
*A*******A*A*
*A*AAAAAAA*A*
*AAA***A***A*
*A*AAA*AAA*A*
*A***A***A*A*
*AAA*AAG*AAA*
*************