*************
*PAAAA*A*G*A*
*A***AAA*A*A*
*A*AAA*A*A*A*
*A***A*A*AAA*
*AAA*AAA*A*A*
*A*AA***AA*A*
*A*AAAAAAA*A*
*A**A*AA***A*
*A*AAAAAAAAA*
*A***A*A***A*
*AAAAAAAAAAA*
*************