*********
*PAAAAAA*
*A*****A*
*AAA*GAA*
***A*A*A*
*A*AAA*A*
*AA****A*
*AAAAAAA*
*********