*********
*PAAAGAA*
*AA****A*
*AAAAA*A*
*AAA*A*A*
*A*AAA*A*
*A*A***A*
*A*AAAAA*
*********