*********
*PAAAAAA*
*A**A**A*
*AAA*AAA*
*AAA*AAA*
*AAAAA*G*
*A*****A*
*AAAAAAA*
*********