*********
*PAAAAAA*
*A*A**AA*
*AAA*AAA*
*A***A***
*A*AAA*A*
*A*AA**A*
*G*AAAAA*
*********