*********
*PAAAA*A*
*A*A*A*A*
*A*AAAAA*
*A*A**AA*
*A*AAAAA*
*AA****A*
*AAG*AAA*
*********