*************
*PAAAAAAAAAA*
***A*A*A**AA*
*AAA*AAA*AAA*
*A*A***AAA***
*A*A*AAA*AAA*
*A*A*A*****A*
*AAAAAAAAA*A*
**AA*****A*A*
*AAA*AAAAA*A*
*A***A****AA*
*AAAAA*GAAAA*
*************