*************
*PAAAAAA*AAA*
*AA****A***A*
*A*AAAAAAAAA*
*AA*AA***A*A*
*AAA*A*AAA*A*
***A*A*A*A***
*AAA*A*A*AAA*
*A***A*****A*
*A*AAA*AAAAA*
*A*A*A*A**AA*
*AAG*AAA*AAA*
*************