*************
*P*AAAAAAAAA*
*A*AA**A*A*A*
*AAAAA*AAA*A*
*A***A*A*A*A*
*AAAAAAA*A*A*
*A***A**AA*A*
*AAA*GAA*A*A*
***AA**A*A*A*
*AAAAA*A*AAA*
*A*A*A*A*A*A*
*AAAAA*AAAAA*
*************