*********
*PAAAA*A*
*AA**A*A*
*A*AAAAA*
*A****AA*
*AAA*A*A*
***A*A*A*
*GAA*AAA*
*********