*********
*PAA*AAA*
*A*A*A*A*
*A*AAA*A*
*A***A*A*
*GAAAAAA*
***A***A*
*AAAAAAA*
*********