*********
*PAAAAAA*
*A*****A*
*AAAAA*A*
*****A*A*
*AAA*G*A*
*A*A***A*
*A*AAAAA*
*********