*********
*P*GAAAA*
*A****AA*
*AAAAA*A*
*A***A*A*
*AAAAA*A*
*A***A*A*
*AAA*AAA*
*********