*********
*PAAAAAA*
*A***A***
*A*A*AAA*
*A*A***A*
*A*AAAAA*
*A*AAAAA*
*AAA*GAA*
*********