*********
*PAA*AAA*
*A*A***A*
*A*AAAAA*
*A*A*****
*A*A*GAA*
*A*A*AAA*
*AAAAAAA*
*********