*************
*PAAAAAA*AAA*
*A*****A*A*A*
*AAAAAAA*A*A*
*A*A**AA*A***
*A*AAA*AAAAA*
*A***AAA*A*A*
*AAA*A*G*A*A*
*A*A*A*A*A*A*
*AAA*AAA*A*A*
*A***A****AA*
*AAAAAAAAAAA*
*************