*************
*PAA*AAAAAAA*
*A*A*A****A**
*A*AAA*AAAAA*
*A*****A***A*
*AAA*AAAAAAA*
*A*A*A*****A*
*A*AAA*AAG*A*
*A*****A***A*
*A*AAA*AAA*A*
*A*A*A***AAA*
*AAA*AAAAAAA*
*************