*********
*PAAAAAA*
**A**A***
*AAAAA*G*
*A*****A*
*AAA*AAA*
*A*AAA***
*A*AAAAA*
*********