*************
*PAA*AAA*AAA*
***A*A*A**AA*
*AAA*A*AAG*A*
*A*A*A*****A*
*AAAAA*AAAAA*
*AA******A*A*
*AAAAAAA*A*A*
****A*AA*A***
*AAAAA*A*AAA*
*A*****A***A*
*AAAAAAAAAAA*
*************