*********
*PAAAAAA*
***A***A*
*AAAAAAA*
*A*A***A*
*A*GAA*A*
*A***A*A*
*AAAAAAA*
*********