*************
*P*AAAAAAAAA*
*A*A***AA****
*AAA*A*AAAAA*
*A***A*****A*
*A*AAA*GAAAA*
*A***A***A*A*
*AAAAA*A*AAA*
*****A*AA****
*AAAAA*AAAAA*
*A****A*AAAA*
*AAAAAAAAA*A*
*************