*********
*PAG*AAA*
*A*A*AAA*
*AAAAA*A*
*A***AAA*
*AAAAA*A*
*A*A***A*
*AAA*AAA*
*********