*********
*PAAAAAA*
*A*****A*
*AAA*AAA*
***A*A***
*AAA*AAA*
*A*A***A*
*AAAAG*A*
*********