***********
*PAAAA*AAA*
*A***A*A*A*
*AAA*AAA*G*
*A*A*A*A***
*A*A*AAA*A*
***A**AA*A*
*AAA*AAA*A*
*A***AA**A*
*AAAAAAAAA*
***********