*************
*P*AAA*AAAAA*
*A*A*A*A***A*
*AAA*AAAAA*A*
****A****AAA*
*AAAAAAAAA*A*
*A*******A*A*
*AAAAAAAAAAA*
*A*********A*
*AAAAAAA*AAA*
*A*A***AAA*A*
*AAAAA*AAGAA*
*************