*********
*G*PAAAA*
*A*AA**A*
*AAA*A*A*
*****A*A*
*AAAAAAA*
*AAA***A*
*AAAAAAA*
*********