*********
*PAA*AAG*
*AA**AA**
*A*AAAAA*
*AAA*A*A*
*AAA*AAA*
*A*****A*
*AAAAAAA*
*********