*************
*P*AAAAAAAAA*
*A*AAA*A***A*
*AAAAA*AAA*A*
*A*******A*A*
*A*AAAAAAA*A*
***A******AA*
*AAA*AAAAAAA*
*A*A*A***A***
*AAAAA*AAAAG*
*A***A*A*****
*AAA*AAAAAAA*
*************