*************
*PAAAAAA*GAA*
*A*A*A***A*A*
*A*A*AAA*AAA*
*A*A***A***A*
*A*AAA*A*AAA*
*A*A**AA*A***
*A*AAAAA*AAA*
*A*AAA*A***A*
*AAAAAAAAAAA*
*A******A****
*AAAAAAAAAAA*
*************