*************
*PAA*AAAAAAA*
*A*A**A****A*
*A*AAAAA*AAA*
*AA***AAAA***
*AAAAGAA*AAA*
***A*******A*
*A*AAA*AAAAA*
*A***A*A*A*A*
*AAAAAAA*A*A*
*A*******AAA*
*AAAAAAAAA*A*
*************