*************
*PAAAA*AAAAA*
*A***A*A*A***
*AAA*AAA*AAA*
*A**A*****AA*
*A*AAAAAAAAA*
*A*A*AA****A*
*AAA*AAAAA*A*
*AAA***A*A*A*
*A*AAAAA*A*A*
*********A*A*
*GAAAAAAAA*A*
*************