*********
*PAAAAAA*
*A*A***A*
*AAAAAAA*
*A***A***
*AAA*AAA*
*A*AAA*A*
*A*GAAAA*
*********