*********
*PAAAAAA*
*A***A***
*AAAAAAA*
*A*****A*
*A*GAAAA*
*AAA*A*A*
*AAA*AAA*
*********