*********
*PAAAAAA*
***A*A***
*AAAAAAA*
*A**AA*A*
*AAA*AAG*
*A*A*A***
*A*AAAAA*
*********