*********
*PAAAAAA*
*A***A*A*
*A*AAAAA*
*AAA***A*
*AAA*AAA*
***A*A***
*AAA*AAG*
*********