*************
*PAAAAAA*AAA*
*A*A***A*A*A*
*A*AAAAA*G*A*
*A*A*A*****A*
*A*A*AAAAA*A*
*A*A**AA*A*A*
*A*AAA*AAAAA*
*A***A*A***A*
*A*A*A*AAA*A*
*A*A*A*A*A*A*
*AAAAAAA*AAA*
*************