*************
*PAAAAAAAAAA*
*A***A*A***A*
*A*AAA*AAAAA*
*A***A*A*****
*AAGAAAA*AAA*
*****A*A***A*
*AAAAAAA*AAA*
*A*A***A*AA**
*A*AAAAA*AAA*
*A*********A*
*AAAAAAAAAAA*
*************