*********
*PAAAA*A*
*A***AAA*
*G*AAAAA*
***A***A*
*AAAAAAA*
*AA******
*AAAAAAA*
*********