*********
*PAAAAAA*
*AA**A***
*AAA*AAA*
***A***A*
*AAA*GAA*
*A*******
*AAAAAAA*
*********