*********
*PAAAAAA*
*A*A**A**
*A*A*GAA*
*AAA***A*
*A*AAA*A*
*AAAAAAA*
*AAAAAAA*
*********