*************
*PAAAAAAAAAA*
*AA********A*
*AAAAA*AAAAA*
**A**A*A*****
*AAA*A*AAAAG*
*A*A*A**A*A**
*A*A*A*AAAAA*
*AA**A***A*A*
*AAAAA*AAA*A*
*A**AA*A*A*A*
*AAAAAAA*AAA*
*************