*************
*PAAAA*AAAAA*
*A***A**A**A*
*A*AAAAA*AAA*
*A*****A*AA**
*AAAAAAA*AAA*
*A*A*A****AA*
*AAA*AAAAAAA*
*AAAA******A*
*A*GAAAAAAAA*
*AA**A*A*A***
*AAAAA*AAAAA*
*************