*************
*PAAAA*AAAAA*
*A*****AAA*A*
*AAA*AAA*A*A*
*AAAAAA**A*A*
*AAA*A*A*AAA*
*A*A*A*A***A*
*AAA*A*AAAAA*
*A*A*A*AAAA**
*A*AAAAA*AAG*
*A*A***A*****
*AAAAAAAAAAA*
*************