*********
*PAAAAAA*
*A*A*AA**
*AAAAA*G*
*A***A*A*
*AAA*A*A*
*A*A**AA*
*AAAAAAA*
*********