*********
*PAAAAAA*
*A**AA*A*
*A*A*A*G*
*A*A*A*A*
*AAA*A*A*
**AA*A*A*
*AAA*AAA*
*********