*********
*PAAAAAG*
*A*******
*AAAAA*A*
*****A*A*
*AAAAA*A*
*A*****A*
*AAAAAAA*
*********