*********
*P*AAAAA*
*A*A*AAA*
*A*A*AAA*
*A*A*A*A*
*AAA*A*A*
*****A*A*
*GAAAA*A*
*********