*********
*PAA*AAA*
*A*A*AAA*
*A*AAA*A*
*A*****A*
*A*G*AAA*
*A*A*AAA*
*AAAAAAA*
*********