*********
*PAAAAAA*
*A***AA**
*A*AAA*G*
*AAA***A*
*A*A*AAA*
*A***A*A*
*AAAAAAA*
*********