*********
*PAG*AAA*
*A***A*A*
*A*AAA*A*
*A*A***A*
*AAA*AAA*
***A*A*A*
*AAAAA*A*
*********