*********
*PAA*AAA*
*A*AAA***
*A*AAAAA*
*A*A***A*
*A*AAAAA*
*A*****A*
*G*AAAAA*
*********