*************
*PAA*AAAAAAA*
*A***A*****A*
*A*AAA*AAAAA*
*AAA**AA***A*
*A*A*A*A*AAA*
*A*A*A*A*A***
*AAA*A*A*AAA*
*A***A*A***A*
*AAAAAAA*AAA*
*****A*A*A*A*
*AAAAA*GAAAA*
*************