*********
*PAA*AAA*
*A*A*A*A*
*G*A*A*A*
***A***A*
*A*AAAAA*
*AA****A*
*AAAAAAA*
*********