*********
*PAAAA*A*
*A**AA*A*
*AAA*AAA*
***A***A*
*AAA*A*A*
*A**AA*A*
*G*AAAAA*
*********