*************
*PAAAAAAAAAA*
*A***A*****A*
*A*G*AAAAA*A*
*A*A**A****A*
*A*AAAAAAAAA*
*A*A*********
*A*AAAAAAAAA*
*AA**A***A***
*AAA*AAA*AAA*
***A*******A*
*AAAAAAAAAAA*
*************