*********
*G*PAAAA*
*AA**A*A*
*AAA*A*A*
***AAA*A*
*A*AAA*A*
*A*****A*
*AAAAAAA*
*********