*********
*PAA*AAA*
*A*A*AAA*
*A*A*A*A*
*A*AAA*A*
*AAA*AAA*
*A*A*A*A*
*A*AAA*G*
*********