*********
*PAAAA*A*
*A**AAAA*
*AAA*A*A*
***A*A*A*
*AAA*G*A*
*A*****A*
*AAAAAAA*
*********