*********
*P*G*AAA*
*AAA*A*A*
*AAA*A*A*
*A**AA*A*
*A*AAA*A*
*A*AA**A*
*AAA*AAA*
*********