*************
*PAAAAAAAA*A*
*A*******AAA*
*AAAAAAA*A*A*
*A**A**A*A*A*
*AAAAAAA*AAA*
*A*A*********
*A*AAAAAAAAA*
*A*********A*
*AAAAAAAAA*G*
*****A*A*A*A*
*AAAAAAA*AAA*
*************