*************
*PAAAA*AAAAA*
*A***A*A***A*
*AAA*A*AAA*A*
*A*A***A***A*
*A*AAAAA*AAA*
*AA*AAA**A*A*
*AAG*A*AAAAA*
*A*AA**A**AA*
*AAA*AAA*A*A*
*AA**AA**A*A*
*AAAAAAAAAAA*
*************