*********
*GPAAAAA*
*A*A***A*
*A*AAA*A*
*A*A***A*
*AAAAAAA*
*******A*
*AAAAAAA*
*********