*************
*PAAAAAAAAAA*
*A*********A*
*A*AAA*A*AAA*
*A*A*A*A*A***
*AAA*A*A*A*A*
*AAA*A*A*A*A*
*A*A*AAA*A*A*
*A*A***A*A*A*
*A*AAA*A*A*A*
*A*A*AA*AA*A*
*GAA*AAAAAAA*
*************