*********
*PAAAAAA*
*AAA*A*A*
*A*A*A*A*
*AAAAA*A*
*AAA*A*A*
*****AAA*
*GAAAAAA*
*********