*********
*P*AAAAA*
*AAAAA***
*AAAAAAA*
*A*A*A*A*
*G*A*AAA*
*A***A*A*
*AAAAA*A*
*********