*************
*PAAAAAAAAAA*
*******A*A*A*
*AAAAAAA*AAA*
*A*****A***A*
*A*AAAAAAAAA*
*A*********A*
*AAAAA*AAA*A*
*AA**AAA*A*A*
*AAA*A*A*AAA*
***A*A***A***
*AAA*AAAAAAG*
*************