*************
*PAAAAAA*AAA*
*A*******A*A*
*AAAAA*AAA*A*
****AA*A*A*A*
*AAAAAAAAA*G*
*A***A***A***
*AAAAAAA*AAA*
*A*****AA**A*
*A*AAA*A*AAA*
*A*A*A*A*A***
*AAAAA*AAAAA*
*************