*************
*PAA*GAAAAAA*
*AAA*******A*
*A*AAAAAAA*A*
*A*******A*A*
*AAA*AAA*AAA*
*A*A*A*A***A*
*A*AAA*AAA*A*
*A*******A*A*
*A*AAAAA*AAA*
*A***A*A**A**
*AAAAA*AAAAA*
*************