*********
*PAAAAAA*
******AA*
*AAAAA*A*
*A***A*A*
*A*G*AAA*
*A*A***A*
*AAA*AAA*
*********