*********
*PAAAAAA*
*A*A*****
*A*A*AAA*
***A*A*A*
*AAA*G*A*
*A*****A*
*AAAAAAA*
*********