*********
*PAA*AAA*
*A*A*A*A*
*G*AAAAA*
***A*AAA*
*AAA*A*A*
*A***A*A*
*AAAAA*A*
*********