*********
*PAAAAAA*
*A*A*A***
*AAA*AAA*
*A*A***A*
*AAG*AAA*
*A**AA*A*
*AAAAA*A*
*********