*********
*PAA*AAA*
*A*A***A*
*G*A*AAA*
***A*A*A*
*A*AAAAA*
*A***A*A*
*AAAAAAA*
*********