*********
*PAAAA*A*
*A*A*AAA*
*AAA*AAA*
*A*A***A*
*A*G*AAA*
*A**AA***
*AAAAAAA*
*********