*********
*PAAAA*A*
*A***A*A*
*AAA*A*A*
*A*AAA*A*
*A*A*AAA*
*A*A*****
*A*AAAAG*
*********