*********
**G   F**
**** ****
**** ****
**** ****
**** ****
**** ****
**P   W**
*********
